1111111111111
1P010000000C1
1M00011111001
100M11CE00001
1111111111111