111111111111111111111111111111111111111
1P0000000000011C00001C0000011C0000000E1
111100010000011000001000000011001111111
11C0000100001100000010000000011000000C1
1000000100011000000000000000C1100000001
100000010001100000001111111111100000001
111111010001100000000000000000100000001
1C00000100000001100000000110000000000C1
111111111111111111111111111111111111111
